0,0,0,0,0,0,0,0,0,0
0,0,0,0,0,0,0,0,0,0
0,1,0,0,0,0,0,1,0,0
0,1,0,0,0,0,0,1,0,0
0,1,0,0,0,0,0,1,0,0
0,1,1,1,1,1,1,1,0,0
0,1,0,0,0,0,0,1,0,0
0,1,0,0,0,0,0,1,0,0
0,1,0,0,0,0,0,1,0,0
0,0,0,0,0,0,0,0,0,0
0,0,0,0,0,0,0,0,0,0
#,17,,,,,,,,
0,0,0,0,0,0,0,0,0,
0,0,0,0,0,0,0,0,0,
0,1,0,0,0,0,1,0,0,
0,1,0,0,0,0,1,0,0,
0,1,0,0,0,0,1,0,0,
0,1,1,1,1,1,1,0,0,
0,1,0,0,0,0,1,0,0,
0,1,0,0,0,0,1,0,0,
0,0,0,0,0,0,0,0,0,
0,0,0,0,0,0,0,0,0,
0,0,0,0,0,0,0,0,0,
#,18,,,,,,,,
0,0,0,0,0,0,0,0,0,0
0,0,0,0,0,0,0,0,0,0
0,0,0,0,0,0,0,0,0,0
0,0,1,0,0,0,1,0,0,0
0,0,1,0,0,0,1,0,0,0
0,0,1,1,1,1,1,0,0,0
0,0,1,0,0,0,1,0,0,0
0,0,1,0,0,0,1,0,0,0
0,0,0,0,0,0,0,0,0,0
0,0,0,0,0,0,0,0,0,0
0,0,0,0,0,0,0,0,0,0
#,13,,,,,,,,