0,0,0,0,0,0,0,0,0,0
0,0,0,0,0,0,0,0,0,0
0,0,0,1,1,1,1,0,0,0
0,0,0,1,1,1,1,0,0,0
0,0,0,1,1,1,1,0,0,0
0,0,0,1,1,1,1,0,0,0
0,0,0,1,1,1,1,0,0,0
0,0,0,1,1,1,1,0,0,0
0,0,0,0,0,0,0,0,0,0
0,0,0,0,0,0,0,0,0,0
0,0,0,0,0,0,0,0,0,0
#,24,,,,,,,,
0,0,0,0,0,0,0,0,0,
0,0,0,1,1,1,0,0,0,
0,0,0,1,1,1,0,0,0,
0,0,0,1,1,1,0,0,0,
0,1,1,1,1,1,1,1,0,
0,1,1,1,1,1,1,1,0,
0,1,1,1,1,1,1,1,0,
0,0,0,1,1,1,0,0,0,
0,0,0,1,1,1,0,0,0,
0,0,0,1,1,1,0,0,0,
0,0,0,0,0,0,0,0,0,
#,39,,,,,,,,
0,0,0,0,0,0,0,0,0,0
0,0,0,0,1,1,0,0,0,0
0,0,0,0,1,1,0,0,0,0
0,0,0,1,1,1,1,0,0,0
0,0,1,1,1,1,1,1,0,0
0,1,1,1,1,1,1,1,1,0
0,0,1,1,1,1,1,1,0,0
0,0,0,1,1,1,1,0,0,0
0,0,0,0,1,1,0,0,0,0
0,0,0,0,1,1,0,0,0,0
0,0,0,0,0,0,0,0,0,0
#,36,,,,,,,,