0,0,0,0,0,0,0,0,0,0
0,0,0,0,0,0,0,0,0,0
0,0,0,0,0,0,0,0,0,0
0,0,0,0,0,0,0,0,0,0
0,0,0,0,0,0,0,0,0,0
0,0,0,0,0,0,0,0,0,0
0,0,0,0,0,0,0,0,0,0
0,0,0,0,0,0,0,0,0,0
0,0,0,0,0,0,0,0,0,0
0,0,0,0,0,0,0,0,0,0
0,0,0,0,0,0,0,0,0,0
#,0,,,,,,,,
0,0,0,0,0,0,0,0,0,
0,0,0,0,0,0,0,0,0,
0,0,1,1,1,1,1,0,0,
0,0,0,1,1,1,0,0,0,
0,0,0,1,0,1,0,0,0,
0,0,1,0,1,0,1,0,0,
0,0,0,1,0,1,0,0,0,
0,0,0,1,1,1,0,0,0,
0,0,1,1,1,1,1,0,0,
0,0,0,0,0,0,0,0,0,
0,0,0,0,0,0,0,0,0,
#,23,,,,,,,,
0,0,0,0,0,0,0,0,0,0
0,0,0,0,0,0,0,0,0,0
0,0,0,0,0,0,0,0,0,0
0,0,0,1,1,1,1,0,0,0
0,0,0,0,1,1,0,0,0,0
0,0,1,0,0,0,0,1,0,0
0,0,1,1,0,0,1,1,0,0
0,0,0,0,1,1,0,0,0,0
0,0,0,1,1,1,1,0,0,0
0,0,0,0,0,0,0,0,0,0
0,0,0,0,0,0,0,0,0,0
#,18,,,,,,,,
0,0,0,0,0,0,0,0,0,
0,0,0,0,0,0,0,0,0,
0,0,0,0,0,0,0,0,0,
0,0,0,1,1,1,0,0,0,
0,0,1,1,0,1,1,0,0,
0,0,1,0,0,0,1,0,0,
0,0,1,0,0,0,1,0,0,
0,0,0,1,1,1,0,0,0,
0,0,0,0,0,0,0,0,0,
0,0,0,0,0,0,0,0,0,
0,0,0,0,0,0,0,0,0,
#,14,,,,,,,,
0,0,0,0,0,0,0,0,0,0
0,0,0,0,0,0,0,0,0,0
0,0,0,0,0,0,0,0,0,0
0,0,0,0,0,0,0,0,0,0
0,0,0,0,1,1,0,0,0,0
0,0,0,1,0,0,1,0,0,0
0,0,0,1,0,0,1,0,0,0
0,0,0,0,0,0,0,0,0,0
0,0,0,0,1,1,0,0,0,0
0,0,0,0,0,0,0,0,0,0
0,0,0,0,0,0,0,0,0,0
#,8,,,,,,,,