0,0,0,0,0,0,0,0,0,0
0,0,0,0,1,1,0,0,0,0
0,0,0,0,1,1,0,0,0,0
0,0,0,0,1,1,0,0,0,0
0,0,0,0,1,1,0,0,0,0
0,1,1,1,1,1,1,1,1,0
0,1,1,1,1,1,1,1,1,0
0,0,1,1,1,1,1,1,0,0
0,0,0,1,1,1,1,0,0,0
0,0,0,0,1,1,0,0,0,0
0,0,0,0,0,0,0,0,0,0
#,36,,,,,,,,
0,0,0,0,0,0,0,0,0,
0,0,0,1,0,1,0,0,0,
0,0,0,1,0,1,0,0,0,
0,0,0,1,0,1,0,0,0,
0,0,0,1,0,1,0,0,0,
0,0,0,1,0,1,0,0,0,
0,1,1,1,1,1,1,1,0,
0,0,1,1,1,1,1,0,0,
0,0,0,1,1,1,0,0,0,
0,0,0,0,1,0,0,0,0,
0,0,0,0,0,0,0,0,0,
#,26,,,,,,,,
0,0,0,0,0,0,0,0,0,0
0,0,0,0,1,1,0,0,0,0
0,0,0,0,1,1,0,0,0,0
0,0,0,0,1,1,0,0,0,0
0,0,0,0,1,1,0,0,0,0
0,1,1,1,1,1,1,1,1,0
0,0,1,1,1,1,1,1,0,0
0,0,0,1,1,1,1,0,0,0
0,0,0,0,1,1,0,0,0,0
0,0,0,0,0,0,0,0,0,0
0,0,0,0,0,0,0,0,0,0
#,28,,,,,,,,