0,0,0,0,0,0,0,0,0,0
0,0,0,0,0,0,0,0,0,0
0,0,0,1,1,1,1,1,0,0
0,0,0,1,1,1,1,1,0,0
0,0,0,1,1,1,1,1,0,0
0,0,0,1,1,1,1,1,0,0
0,0,0,1,1,1,1,1,0,0
0,0,0,1,1,1,1,1,0,0
0,0,0,0,0,0,0,0,0,0
0,0,0,0,0,0,0,0,0,0
0,0,0,0,0,0,0,0,0,0
#,30,,,,,,,,
0,0,0,0,0,0,0,0,0,
0,0,0,0,0,0,0,0,0,
0,0,1,1,1,1,1,1,0,
0,0,1,0,0,0,0,1,0,
0,0,1,0,1,1,1,1,0,
0,0,1,0,0,1,0,1,0,
0,0,1,0,0,0,0,1,0,
0,0,1,1,1,1,1,1,0,
0,0,0,0,0,0,0,0,0,
0,0,0,0,0,0,0,0,0,
0,0,0,0,0,0,0,0,0,
#,24,,,,,,,,
0,0,0,0,0,0,0,0,0,0
0,1,0,1,0,1,0,1,0,0
0,0,1,0,1,0,1,0,1,0
0,1,0,1,0,1,0,1,0,0
0,0,1,0,1,0,1,0,1,0
0,1,0,1,0,1,0,1,0,0
0,0,1,0,1,0,1,0,1,0
0,1,0,1,0,1,0,1,0,0
0,0,1,0,1,0,1,0,1,0
0,1,0,1,0,1,0,1,0,0
0,0,0,0,0,0,0,0,0,0
#,36,,,,,,,,